#########################
#P O       R            #
#   ####     #####      #
#     ##               ##
#        G              #
#   ##        ##        #
#                       #
#             A         #
#                       #
#                       #
#                       #
#                       #
#                       #
#########################
