#########################
#P  O      A            #
#   ####    R ######    #
#         ####          #
#   ##        ##        #
#                       #
#        G              #
#                       #
#                       #
#     ##                #
#                       #
#                       #
#                       #
#########################
