#########################
#      R                #
#   ####     #####      #
#                       #
#        G              #
#   ##        ##        #
#                       #
#                       #
#  P          O         #
#                       #
#                       #
#                       #
#         A             #
#########################
